1111111111111111111111111111
1E00010C000000000000000000001
1P00111000000000000000000001
1000000000000000000000000001
1000000000000000000000000001
100C000000000000000000000001
1111111111111111111111111111
