111111111111111111
100C1C000000C00001
10111111000000C0E1
100000000011100001
10000C000010C00001
1000000000100CC001
1000000P00100CC001
110111111110000001
100000000000000001
1C0000000000000C01
111111111111111111
