1111111111111111111111111111
1E0C010C01000000000000000001
10P0111011000000000000000001
1000000000000000000000000001
1000000000000000000000000001
100C000000000000000000000001
1111111111111111111111111111
